################################################################
#..............................................................#
#..............................................................#
#..............................................................#
#..............................................................#
#..............................................................#
#..............................................................#
#..............................................................#
#..............................................................#
#..............................................................#
#..............................................................#
#..............................................................#
#...........########################################...........#
#...........########################################...........#
#...........########################################...........#
#...........###................................................#
#...........###................................................#
#...........###................................................#
#...........###................................................#
#...........###................................................#
#...........###................................................#
#...........###................................................#
#...........###................................................#
#...........###................................................#
#...........###................................................#
#...........###................................................#
#...........###...........######################################
#...........###...........######################################
#...........###...........######################################
#...........###...........###........................###......E#
#...........###...........###........................###.......#
#...........###...........###........................###.......#
#...........###...........###........................###.......#
#...........###...........###........................###.......#
#...........###...........###........................###.......#
#...........###...........###........................###.......#
#...........###................................................#
#...........###................................................#
#...........###................................................#
#...........###................................................#
#...........###........................###.....................#
#...........###........................###.....................#
#...........###........................###.....................#
#...........###........................###.....................#
#...........###........................###.....................#
#...........###........................###.....................#
#S..........###........................###.....................#
################################################################