####################################################################################################
#..................................................................................................#
#..................................................................................................#
#..................................................................................................#
#..................................................................................................#
#..................................................................................................#
#..................................................................................................#
#..................................................................................................#
#..................................................................................................#
#..................................................................................................#
#..................................................................................................#
#..................................................................................................#
#...........############################################################################...........#
#...........############################################################################...........#
#...........############################################################################...........#
#...........###....................................................................................#
#...........###....................................................................................#
#...........###....................................................................................#
#...........###....................................................................................#
#...........###....................................................................................#
#...........###....................................................................................#
#...........###....................................................................................#
#...........###....................................................................................#
#...........###....................................................................................#
#...........###....................................................................................#
#...........###....................................................................................#
#...........###...........##########################################################################
#...........###...........##########################################################################
#...........###...........##########################################################################
#...........###...........###........................###.........................###..............E#
#...........###...........###........................###.........................###...............#
#...........###...........###........................###.........................###...............#
#...........###...........###........................###.........................###...............#
#...........###...........###........................###.........................###...............#
#...........###...........###........................###.........................###...............#
#...........###...........###........................###.........................###...............#
#...........###....................................................................................#
#...........###....................................................................................#
#...........###....................................................................................#
#...........###....................................................................................#
#...........###........................###.........................###.............................#
#...........###........................###.........................###.............................#
#...........###........................###.........................###.............................#
#...........###........................###.........................###.............................#
#S..........###........................###.........................###.............................#
#...........###........................###.........................###.............................#
#...........###........................###.........................###.............................#
####################################################################################################